R 1024 768

SO textures/South.xpm
NO textures/North.xpm
WE textures/West.xpm
EA textures/East.xpm
S textures/mguard.xpm

F  61, 107, 0
C  150, 150, 200

1111
1001     111111
100111111100001
1000000000000W1
100000000000001
100001111000001
102201  1000001
100001  100000111111111
100001  100000000000001
100001  100000000000001
111111  120110000000001
        100110000000001
        111111111000001
                1000001
                1000001
                1000001
                1000001
                1000001
                1000001
                1000001
                1000001
                1000001
                1000001
                1000001
                1000001
                1000001
                1000001
                1000001
                1000001
                1000001
                1000001
                1000001
                1000001
                1000001
                1000001
                1000001
                1000001
                1000001
                1000001
                1000001
                1000001
                1000001
                1000001
                1000001
                1000001
                1000001
                1000001
                1000001
                1000001
                1000001
                1000001
                1000001
                1000001
                1000001
                1000001
                1000001
                1000001
                1000001
                1000001
                1000001
                1000001
                1000001
                1000001
                1000001
                1000001
                1000001
                1000001
                1000001
                1000001
                1000001
                1000001
                1000001
                1000001
                1000001
                1000001
                1000001
                1000001
                1000001
                1000001
                1000001
                1000001
                1000001
                1000001
                1000001
                1000001
                1000001
                1000001
                1000001
                1000001
                1000001
                1000001
                1111111