R 1024 768

SO textures/South.xpm
NO textures/North.xpm
WE textures/West.xpm
EA textures/East.xpm
S textures/knight.xpm

F 61,107,0
C 150,150,200

      11111111   1111111
111111S0000001   1000021   111111
100000000000011111000001   100001
100000000000000000000001111100001
100000000000001000000000000000001
111000100000000000000000000000001
  1000000011100000000001110000001
  100020001 100000000001 11111111
  100010001 100001100001
  100212221 100021 12001
  111111111  1111   111