R 1000  1000

SO  textures/South.xpm
NO textures/North.xpm
WE textures/West.xpm
EA textures/East.xpm
S textures/knight.xpm

F  1,     0,     252
C  12,0,0

11111
1W001
11111